111111111111111111111111
100000000000000000000011
100000000000000000000011
10000000P000000000000011
100000000000000000000011
10000000000000C000000011
100000000000000000000011
100000000000000000000011
1C0000000000000000000E11
111111111110111111111111
100000000000000000000011
10000C000000000000000011
100000000000000000000C11
111111111111111111111111
