1111111111111111
1000P000C00000E1
1111111111111111
