11111111111111111111111
10000000000000000000001
10000000000000000000001
10000000P00000000000001
10000000000000000000001
10000000000000C00000001
10000000000000000000001
10000000000000000N00001
1C0000000000000000000E1
11111111111011111111111
10000000000000000000001
10000C00000000000000001
100000000000000000000C1
11111111111111111111111
